妙蛙种子	茂盛
妙蛙草	茂盛
妙蛙花	茂盛
超级妙蛙花	厚脂肪
小火龙	勐火
火恐龙	勐火
喷火龙	勐火
超级喷火龙Ｘ	硬爪
超级喷火龙Ｙ	日照
杰尼龟	激流
卡咪龟	激流
水箭龟	激流
超级水箭龟	超级发射器
绿毛虫	鳞粉
铁甲蛹	蜕皮
巴大蝶	复眼
独角虫	鳞粉
铁壳蛹	蜕皮
大针蜂	虫之预感
超级大针蜂	适应力
波波	锐利目光
比比鸟	锐利目光
大比鸟	锐利目光
超级大比鸟	无防守
小拉达	逃跑
拉达	逃跑
烈雀	锐利目光
大嘴雀	锐利目光
阿柏蛇	威吓
阿柏怪	威吓
皮卡丘	静电
雷丘	静电
穿山鼠	沙隐
穿山王	沙隐
尼多兰	毒刺
尼多娜	毒刺
尼多后	毒刺
尼多朗	毒刺
尼多力诺	毒刺
尼多王	毒刺
皮皮	迷人之躯
皮可西	迷人
六尾	引火
九尾	引火
胖丁	迷人之躯
胖可丁	迷人之躯
超音蝠	精神力
大嘴蝠	精神力
走路草	叶绿素
臭臭花	叶绿素
霸王花	叶绿素
派拉斯	孢子
派拉斯特	孢子
毛球	复眼
摩鲁蛾	鳞粉
地鼠	沙隐
三地鼠	沙隐
猫老大	柔软
可达鸭	湿气
哥达鸭	湿气
猴怪	干劲
火爆猴	干劲
卡蒂狗	威吓
风速狗	威吓
蚊香蝌蚪	储水
蚊香君	储水
蚊香泳士	储水
凯西	同步
勇基拉	同步
胡地	同步
超级胡地	复制
腕力	毅力
豪力	毅力
怪力	毅力
喇叭芽	叶绿素
口呆花	叶绿素
大食花	叶绿素
玛瑙水母	恒净之躯
毒刺水母	恒净之躯
小拳石	坚硬
隆隆石	坚硬
隆隆岩	坚硬
小火马	逃跑
烈焰马	逃跑
呆呆兽	迟钝
呆壳兽	迟钝
超级呆壳兽	硬壳盔甲
小磁怪	磁力
三合一磁怪	磁力
大葱鸭	锐利目光
嘟嘟	逃跑
嘟嘟利	逃跑
小海狮	厚脂肪
白海狮	厚脂肪
臭泥	恶臭
臭臭泥	恶臭
大舌贝	硬壳盔甲
刺甲贝	硬壳盔甲
鬼斯	飘浮
鬼斯通	飘浮
耿鬼	诅咒之躯
超级耿鬼	踩影
大岩蛇	坚硬脑袋
催眠貘	不眠
引梦貘人	不眠
大钳蟹	怪力钳
巨钳蟹	怪力钳
霹雳电球	隔音透过
顽皮雷弹	隔音透过
蛋蛋	叶绿素
椰蛋树	叶绿素
卡拉卡拉	坚硬脑袋
嘎啦嘎啦	坚硬脑袋
飞腿郎	柔软
快拳郎	锐利目光
大舌头	我行我素
瓦斯弹	飘浮
双弹瓦斯	飘浮
独角犀牛	避雷针
钻角犀兽	避雷针
吉利蛋	自然回复
蔓藤怪	叶绿素
袋兽	早起
超级袋兽	亲子爱
墨海马	悠游自如
海刺龙	毒刺
角金鱼	悠游自如
金鱼王	悠游
海星星	发光
宝石海星	发光
魔墙人偶	隔音
飞天螳螂	虫之预感
迷唇姐	迟钝
电击兽	静电
鸭嘴火兽	火焰之躯
凯罗斯	怪力钳
超级凯罗斯	飞行皮肤
肯泰罗	威吓
鲤鱼王	悠游自如
暴鲤龙	威吓
超级暴鲤龙	破格
拉普拉斯	储水
百变怪	柔软
伊布	逃跑
水伊布	储水
雷伊布	蓄电
火伊布	引火
多边兽	复制
菊石兽	悠游自如
多刺菊石兽	悠游自如
化石盔	悠游自如
镰刀盔	悠游自如
化石翼龙	坚硬脑袋
超级化石翼龙	硬爪
卡比兽	免疫
急冻鸟	压迫
闪电鸟	压迫
火焰鸟	压迫
迷你龙	蜕皮
哈克龙	蜕皮
快龙	精神力
超梦	压迫感
超级超梦Ｘ	不屈之心
梦幻	同步
菊草叶	茂盛
月桂叶	茂盛
大竺葵	茂盛
火球鼠	勐火
火岩鼠	勐火
火爆兽	勐火
小锯鳄	激流
蓝鳄	激流
大力鳄	激流
尾立	逃跑
大尾立	逃跑
咕咕	不眠
猫头夜鹰	不眠
芭瓢虫	虫之预感
安瓢虫	虫之预感
圆丝蛛	虫之预感
阿利多斯	虫之预感
叉字蝠	精神力
灯笼鱼	蓄电
电灯怪	蓄电
皮丘	静电
皮宝宝	迷人之躯
宝宝丁	迷人之躯
波克比	活力
波克基古	活力
天然雀	同步
天然鸟	同步
咩利羊	静电
茸茸羊	静电
电龙	静电
超级电龙	破格
美丽花	叶绿
玛力露	厚脂肪
玛力露丽	厚脂肪
树才怪	结实
蚊香蛙皇	储水
毽子草	叶绿素
毽子花	叶绿素
毽子棉	叶绿素
长尾怪手	逃跑
向日种子	叶绿素
向日花怪	叶绿素
蜻蜻蜓	加速
乌波	湿气透过
沼王	湿气透过
太阳伊布	同步
月亮伊布	同步
黑暗鸦	不眠
呆呆王	迟钝
梦妖	飘浮
未知图腾	飘浮
果然翁	踩影
麒麟奇	精神力
榛果球	结实
佛烈托斯	结实
土龙弟弟	天恩
天蝎	怪力钳
大钢蛇	坚硬脑袋
超级大钢蛇	沙之力
布鲁	威吓
布鲁皇	威吓
千针鱼	毒刺
巨钳螳螂	虫之预感
超级巨钳螳螂	技术高手
壶壶	结实
赫拉克罗斯	虫之预感
超级赫拉克罗斯	连续
狃拉	精神力
熊宝宝	捡拾
圈圈熊	毅力
熔岩虫	熔岩
熔岩蜗牛	熔岩
小山猪	迟钝
长毛猪	迟钝
太阳珊瑚	活力
铁炮鱼	活力
章鱼桶	吸盘
信使鸟	干劲
巨翅飞鱼	悠游自如
盔甲鸟	锐利目光
戴鲁比	早起
黑鲁加	早起
超级黑鲁加	太阳之力
刺龙王	悠游自如
小小象	捡拾
顿甲	结实
多边兽Ⅱ	复制
惊角鹿	威吓
图图犬	我行我素
无畏小子	毅力
战舞郎	威吓
迷唇娃	迟钝
电击怪	静电
鸭嘴宝宝	火焰之躯
大奶罐	厚脂肪
幸福蛋	自然回复
雷公	压迫感
炎帝	压迫感
水君	压迫感
幼基拉斯	毅力
沙基拉斯	蜕皮
班基拉斯	扬沙
超级班基拉斯	扬沙
洛奇亚	压迫感
凤王	压迫感
时拉比	自然回复 
木守宫	茂盛
森林蜥蜴	茂盛
蜥蜴王	茂盛
超级蜥蜴王	避雷针
火稚鸡	勐火
力壮鸡	勐火
火焰鸡	勐火
超级火焰鸡	加速
水跃鱼	激流
沼跃鱼	激流
巨沼怪	激流
超级巨沼怪	悠游自如
土狼犬	逃跑
大狼犬	威吓
蛇纹熊	捡拾
直冲熊	捡拾
刺尾虫	鳞粉
甲壳茧	蜕皮
狩猎凤蝶	虫之预感
盾甲茧	蜕皮
毒粉蛾	鳞粉
莲叶童子	悠游自如
莲帽小童	悠游自如
乐天河童	悠游自如 
橡实果	叶绿素 
长鼻叶	叶绿素 
狡猾天狗	叶绿素
傲骨燕	毅力
大王燕	毅力
长翅鸥	锐利目光
大嘴鸥	锐利目光
拉鲁拉丝	同步
奇鲁莉安	同步
沙奈朵	同步
超级沙奈朵	妖精皮肤
熘熘糖球	悠游自如
雨翅蛾	威吓
蘑蘑菰	孢子
斗笠菰	孢子
懒人獭	懒惰
过动猿	干劲
请假王	懒惰
土居忍士	复眼
铁面忍者	加速
脱壳忍者	神奇
咕妞妞	隔音
吼爆弹	隔音
爆音怪	隔音
幕下力士	厚脂肪
铁掌力士	厚脂肪
露力丽	厚脂肪
朝北鼻	结实
向尾喵	迷人之躯
优雅猫	迷人之躯
勾魂眼	锐利目光
超级勾魂眼	魔法镜
大嘴娃	怪力
超级大嘴娃	大力士
可可多拉	结实
可多拉	结实
波士可多拉	结实
超级波士可多拉	过滤
玛沙那	瑜伽之力
恰雷姆	瑜伽之力
落雷兽	静电
雷电兽	静电
超级雷电兽	威吓
正电拍拍	正电
负电拍拍	负电
电萤虫	发光
甜甜萤	迟钝
毒蔷薇	自然
溶食兽	污泥浆
吞食兽	污泥浆
利牙鱼	粗糙皮肤
巨牙鲨	粗糙
超级巨牙鲨	强壮之颚
吼吼鲸	水幕
吼鲸王	水幕
呆火驼	迟钝
喷火驼	熔岩
超级喷火驼	强行
煤炭龟	白色烟雾
跳跳猪	厚脂肪
噗噗猪	厚脂肪
晃晃斑	我行我素
大颚蚁	怪力钳
超音波幼虫	飘浮
沙漠蜻蜓	飘浮
刺球仙人掌	沙隐
梦歌仙人掌	沙隐
青绵鸟	自然回复
七夕青鸟	自然回复
超级七夕青鸟	妖精皮肤
猫鼬斩	免疫
饭匙蛇	蜕皮
月石	飘浮
太阳岩	飘浮
泥泥鳅	迟钝
鲶鱼王	迟钝
龙虾小兵	怪力钳
铁螯龙虾	怪力钳
天秤偶	飘浮
念力土偶	飘浮
触手百合	吸盘
摇篮百合	吸盘
太古羽虫	战斗盔甲
太古盔甲	战斗盔甲
丑丑鱼	悠游自如
美纳斯	神奇鳞片
飘浮泡泡	阴晴不定
变隐龙	变色
怨影娃娃	不眠
诅咒娃娃	不眠
超级诅咒娃娃	恶作剧之心
夜巡灵	飘浮
彷徨夜灵	压迫感
热带龙	叶绿素
风铃铃	飘浮
阿勃梭鲁	压迫感
超级阿勃梭鲁	魔法镜
小果然	踩影
雪童子	精神力
冰鬼护	精神力
超级冰鬼护	冰冻皮肤
海豹球	厚脂肪
海魔狮	厚脂肪
帝牙海狮	厚脂肪
珍珠贝	硬壳盔甲
猎斑鱼	悠游自如
樱花鱼	悠游自如
古空棘鱼	悠游自如
爱心鱼	悠游自如
宝贝龙	坚硬脑袋
甲壳龙	坚硬
暴飞龙	威吓
超级暴飞龙	飞行
铁哑铃	纯净之躯
金属怪	纯净之躯
巨金怪	纯净之躯
超级巨金怪	硬爪
雷吉洛克	纯净之躯
雷吉艾斯	纯净之躯
雷吉斯奇鲁	纯净之躯
拉帝亚斯	飘浮
超级拉帝亚斯	飘浮
拉帝欧斯	飘浮
超级拉帝欧斯	飘浮
盖欧卡	降雨
固拉多	日照
烈空坐	气闸
超级烈空坐	德尔塔气流
基拉祈	天恩
代欧奇希斯	压迫
草苗龟	茂盛
树林龟	茂盛
土台龟	茂盛
小火焰猴	勐火
勐火猴	勐火
烈焰猴	勐火
波加曼	激流
波皇子	激流
帝王拿波	激流
姆克儿	锐利目光
姆克鸟	威吓
姆克鹰	威吓
大牙狸	单纯
大尾狸	单纯
圆法师	蜕皮
音箱蟀	虫之
小猫怪	斗争心
勒克猫	斗争心
伦琴猫	斗争心
含羞苞	自然回复
罗丝雷朵	自然回复
头盖龙	破格
战槌龙	破格
盾甲龙	结实
护城龙	结实
结草儿	蜕皮
结草贵妇	危险
绅士蛾	虫之预感
三蜜蜂	采蜜
蜂女王	压迫感
帕奇利兹	逃跑
泳圈鼬	悠游自如
浮潜鼬	悠游自如
樱花宝	叶绿素
樱花儿	花之礼
无壳海兔	黏着
海兔兽	黏着
双尾怪手	技术
飘飘球	引爆
随风球	引爆
卷卷耳	逃跑
长耳兔	迷人之躯
超级长耳兔	胆量
梦妖魔	飘浮
乌鸦头头	不眠
魅力喵	柔软
东施喵	厚脂肪
铃铛响	飘浮
臭鼬噗	恶臭
坦克臭鼬	恶臭
铜镜怪	飘浮
青铜钟	飘浮
盆才怪	结实
魔尼尼	隔音 
小福蛋	自然回复
聒噪鸟	锐利目光
花岩怪	压迫感
圆陆鲨	沙隐
尖牙陆鲨	沙隐
烈咬陆鲨	沙隐
小卡比兽	捡拾
利欧路	不屈之心
路卡利欧	不屈之心
超级路卡利欧	适应力
沙河马	扬沙
河马兽	扬沙
钳尾蝎	战斗盔甲
龙王蝎	战斗盔甲
不良蛙	危险预知
毒骷蛙	危险预知
尖牙笼	飘浮
萤光鱼	悠游自如
霓虹鱼	悠游自如
小球飞鱼	悠游自如
雪笠怪	降雪
暴雪王	降雪
超级暴雪王	降雪
玛狃拉	压迫感
自爆磁怪	磁力
大舌舔	我行我素
超甲狂犀	避雷针
巨蔓藤	叶绿素
电击魔兽	电气
鸭嘴炎兽	火焰之躯
波克基斯	活力
远古巨蜓	加速
叶伊布	叶子
冰伊布	雪隐
天蝎王	怪力钳
象牙猪	迟钝
多边兽Ｚ	适应力
艾路雷朵	不屈之心
超级艾路雷朵	精神力
大朝北鼻	结实
黑夜魔灵	压迫感
雪妖女	雪隐
洛托姆	飘浮
由克希	飘浮
艾姆利多	飘浮
亚克诺姆	飘浮
帝牙卢卡	压迫感
帕路奇亚	压迫感
席多蓝恩	引火
雷吉奇卡斯	慢启动
骑拉帝纳	压迫感
克雷色利亚	飘浮
霏欧纳	湿润之躯
玛纳霏	湿润之躯
达克莱伊	梦魇
谢米	自然回复
阿尔宙斯	特多 
比克提尼	胜利之星
藤藤蛇	茂盛
青藤蛇	茂盛
君主蛇	茂盛
暖暖猪	勐火
炒炒猪	勐火
炎武王	勐火
水水獭	激流
双刃丸	激流
大剑鬼	激流
探探鼠	逃跑
步哨鼠	发光
小约克	干劲
哈约克	威吓
长毛狗	威吓
扒手猫	柔软
酷豹	柔软
花椰猴	贪吃鬼
爆香猴	贪吃鬼
爆香猿	贪吃鬼
冷水猴	贪吃鬼
冷水猿	贪吃鬼
食梦梦	预知梦
梦梦蚀	预知梦
豆豆鸽	健壮 
咕咕鸽	健壮
高傲雉鸡	健壮
斑斑马	避雷针
雷电斑马	避雷针
石丸子	结实
地幔岩	结实
庞岩怪	结实
滚滚蝙蝠	纯朴
心蝙蝠	纯朴
螺钉地鼠	拨沙
龙头地鼠	拨沙
差不多娃娃	治愈之心
超级差不多娃娃	治愈之心
搬运小匠	毅力
铁骨土人	毅力
修建老匠	毅力
圆蝌蚪	悠游自如
蓝蟾蜍	悠游自如
蟾蜍王	悠游自如
投摔鬼	毅力
打击鬼	结实
虫宝包	虫之预感
宝包茧	叶子防守
保母虫	虫之预感
百足蜈蚣	毒刺
车轮毬	毒刺
蜈蚣王	毒刺
木棉球	恶作剧之心
风妖精	恶作剧之心
百合根娃娃	叶绿素
裙儿小姐	叶绿素
野蛮鲈鱼	舍身
黑眼鳄	威吓
溷溷鳄	威吓
流氓鳄	威吓
火红不倒翁	活力
达摩狒狒	强行
沙铃仙人掌	储水
石居蟹	结实
岩殿居蟹	结实
滑滑小子	蜕皮
头巾溷溷	蜕皮
象征鸟	奇迹皮肤
哭哭面具	木乃伊
死神棺	木乃伊
原盖海龟	坚硬岩石
肋骨海龟	坚硬岩石
始祖小鸟	软弱
始祖大鸟	软弱
破破袋	恶臭
灰尘山	恶臭
索罗亚	幻觉
索罗亚克	幻觉
泡沫栗鼠	迷人之躯
奇诺栗鼠	迷人之躯
哥德宝宝	察觉
哥德小童	察觉
哥德小姐	察觉
单卵细胞球	防尘
人造细胞卵	防尘
鸭宝宝	锐利目光
舞天鹅	锐利目光
迷你冰	冰冻之躯
多多冰	冰冻之躯
双倍多多冰	冰冻之躯
四季鹿	叶绿素
萌芽鹿	叶绿素
电飞鼠	静电
盖盖虫	虫之预感
骑士蜗牛	虫之预感
哎呀球菰	孢子
败露球菰	孢子
轻飘飘	储水
胖嘟嘟	储水
保母曼波	治愈之心
电电虫	复眼
电蜘蛛	复眼
种子铁球	铁刺
坚果哑铃	铁刺
齿轮儿	正电
齿轮组	正电
麻麻小鱼	飘浮
麻麻鳗	飘浮
麻麻鳗鱼王	飘浮
小灰怪	心灵感应
大宇怪	心灵感应
烛光灵	引火
灯火幽灵	引火
水晶灯火灵	引火
牙牙	斗争心
斧牙龙	斗争心
双斧战龙	斗争心
喷嚏熊	雪隐
冻原熊	雪隐
几何雪花	飘浮
小嘴蜗	湿润之躯
敏捷虫	湿润之躯
泥巴鱼	静电
功夫鼬	精神力
师父鼬	精神力
赤面龙	粗糙皮肤
泥偶小人	铁拳
泥偶巨人	铁拳
驹刀小兵	不服输
噼斩司令	不服输
爆炸头水牛	舍身
毛头小鹰	锐利目光
勇士雄鹰	锐利目光
秃鹰丫头	健壮
秃鹰娜	健壮
熔蚁兽	贪吃鬼
铁蚁	虫之预感
单首龙	活力
双首暴龙	活力
三首恶龙	飘浮
燃烧虫	火焰之躯
勾帕路翁	正义之心
代拉基翁	正义之心
毕力吉翁	正义之心
龙卷云	恶作剧之心
雷电云	恶作剧之心
莱希拉姆	涡轮火焰
捷克罗姆	兆级电压
土地云	沙之力
酋雷姆	压迫感
凯路迪欧	正义之心
美洛耶塔	天恩
盖诺赛克特	下载
哈力栗	茂盛
胖胖哈力	茂盛
布里卡隆	茂盛
火狐狸	勐火
长尾火狐	勐火
妖火红狐	勐火
呱呱泡蛙	激流
呱头蛙	激流
甲贺忍蛙	激流
掘掘兔	捡拾
掘地兔	捡拾
小箭雀	健壮
火箭雀	火焰之躯
烈箭鹰	火焰之躯
粉蝶虫	鳞粉
粉蝶蛹	蜕皮
彩粉蝶	鳞粉
小狮狮	斗争心
火炎狮	斗争心
花蓓蓓	花幕
花叶蒂	花幕
花洁夫人	花幕
坐骑小羊	食草
坐骑山羊	食草
顽皮熊猫	铁拳
流氓熊猫	铁拳
多丽米亚	毛皮大衣
妙喵	锐利目光
超能妙喵	锐利目光
独剑鞘	无防守
双剑鞘	无防守
坚盾剑怪	战斗切换
粉香香	治愈之心
芳香精	治愈之心
绵绵泡芙	甜幕自己
胖甜妮	甜幕自己
好啦鱿	唱反调
乌贼王	唱反调
龟脚脚	硬爪
龟足巨铠	硬爪
垃垃藻	毒刺
毒藻龙	毒刺
铁臂枪虾	超级发射器
钢炮臂虾	超级发射器
伞电蜥	干燥皮肤
光电伞蜥	干燥皮肤
宝宝暴龙	强壮之颚
怪颚龙	强壮之颚
冰雪龙	冰冻皮肤
冰雪巨龙	冰冻皮肤
仙子伊布	迷人之躯
摔角鹰人	柔软
咚咚鼠	颊囊
小碎钻	恒净之躯
黏黏宝	食草
黏美儿	食草
黏美龙	食草
钥圈儿	恶作剧之心
小木灵	自然回复
朽木妖	自然回复
南瓜精	捡拾
南瓜怪人	捡拾
冰宝	我行我素
冰岩怪	我行我素
嗡蝠	察觉
音波龙	察觉
哲尔尼亚斯	妖精气场
伊裴尔塔尔	暗黑气场
基格尔德	气场破坏
蒂安希	恒净之躯
超级蒂安希	魔法镜
胡帕	魔术师
波尔凯尼恩	储水
木木枭	茂盛
投羽枭	茂盛
狙射树枭	茂盛
火斑喵	勐火
炎热喵	勐火
炽焰咆哮虎	勐火
球球海狮	激流
花漾海狮	激流
西狮海壬	激流
小笃儿	锐利目光
喇叭啄鸟	锐利目光
铳嘴大鸟	锐利目光
猫鼬少	监视
猫鼬探长	监视
强颚鸡母虫	虫之预感
虫电宝	蓄电
锹农炮虫	飘浮
好胜蟹	怪力钳
好胜毛蟹	怪力钳
花舞鸟	舞者
萌虻	采蜜
蝶结萌虻	采蜜
岩狗狗	锐利目光
鬃岩狼人	锐利目光
弱丁鱼	鱼群
好坏星	不仁不义
超坏星	不仁不义
泥驴仔	我行我素
重泥挽马	我行我素
滴蛛	水泡
滴蛛霸	水泡
伪螳草	叶子防守
兰螳花	叶子防守
睡睡菰	发光
灯罩夜菰	发光
夜盗火蜥	腐蚀
焰后蜥	腐蚀
童偶熊	毛茸茸
穿着熊	毛茸茸
甜竹竹	叶子防守
甜舞妮	叶子防守
甜冷美后	叶子防守
花疗环环	花幕
智挥猩	精神力
投掷猴	接球手
胆小虫	跃跃欲逃
具甲武者	危险回避
沙丘娃	遇水凝固
噬沙堡爷	遇水凝固
拳海参	飞出的内在物
属性：空	战斗盔甲
银伴战兽	ＡＲ系统
小陨星	界限盾壳
树枕尾熊	绝对睡眠
爆焰龟兽	硬壳盔甲
托戈德玛尔	铁刺
谜拟Ｑ	画皮
磨牙彩皮鱼	鲜艳之躯
老翁龙	怒火冲天
破破舵轮	钢能力者
心鳞宝	防弹
鳞甲龙	防弹
杖尾鳞甲龙	防弹
卡璞・鸣鸣	电气制造者
卡璞・蝶蝶	精神制造者
卡璞・哞哞	青草制造者
卡璞・鳍鳍	薄雾制造者
科斯莫古	纯朴
科斯莫姆	结实
索尔迦雷欧	金属
露奈雅拉	幻影
虚吾伊德	异兽提升
爆肌蚊	异兽提升
费洛美螂	异兽提升
电束木	异兽提升
铁火辉夜	异兽提升
纸御剑	异兽提升
恶食大王	异兽提升
奈克洛兹玛	棱镜装甲
玛机雅娜	魂心
玛夏多	技术高手
毒贝比	异兽提升
四颚针龙	异兽
垒磊石	异兽
砰头小丑	异兽
捷拉奥拉	蓄电
美录坦	磁力
美录梅塔	铁拳
敲音猴	茂盛
啪咚猴	茂盛
轰擂金刚猩	茂盛
炎兔儿	勐火
腾蹴小将	勐火
闪焰王牌	勐火
泪眼蜥	激流
变涩蜥	激流
千面避役	激流
贪心栗鼠	颊囊
藏饱栗鼠	颊囊
稚山雀	锐利目光
蓝鸦	锐利目光
钢铠鸦	压迫感
索侦虫	虫之预感
天罩虫	虫之预感
以欧路普	虫之预感
偷儿狐	逃跑
狐大盗	逃跑
幼棉棉	棉絮
白蓬蓬	棉絮
毛辫羊	毛茸茸
毛毛角羊	毛茸茸
咬咬龟	强壮之颚
暴噬龟	强壮之颚
来电汪	捡球
逐电犬	强壮之颚
小炭仔	蒸汽机
大炭车	蒸汽机
巨炭山	蒸汽机
啃果虫	熟成
苹裹龙	熟成
丰蜜龙	熟成
沙包蛇	吐沙
沙螺蟒	吐沙
古月鸟	一口飞弹
刺梭鱼	悠游自如
戽斗尖梭	悠游自如
毒电婴	胆怯
颤弦蝾螈	庞克
烧火蚣	引火
焚焰蚣	引火
拳拳蛸	柔软
八爪武师	柔软
来悲茶	碎裂铠甲
怖思壶	碎裂铠甲
迷布莉姆	治愈之心
提布莉姆	治愈之心
布莉姆温	治愈之心
捣蛋小妖	恶作剧之心
诈唬魔	恶作剧之心
长毛巨魔	恶作剧之心
堵拦熊	舍身
喵头目	战斗盔甲
魔灵珊瑚	碎裂铠甲
葱游兵	不屈之心
踏冰人偶	蹒跚
死神板	游魂
小仙奶	甜幕
霜奶仙	甜幕
列阵兵	战斗盔甲
啪嚓海胆	避雷针
雪吞虫	鳞粉
雪绒蛾	鳞粉
巨石丁	能量
冰砌鹅	结冻
爱管侍	精神力
莫鲁贝可	饱了又饿
铜象	强行
大王铜象	强行
雷鸟龙	蓄电
雷鸟海兽	蓄电
鳃鱼龙	储水
鳃鱼海兽	储水
铝钢龙	金属
多龙梅西亚	恒净之躯
多龙奇	恒净之躯
多龙巴鲁托	恒净之躯
苍响	不挠之剑
藏玛然特	不屈之盾
无极汰那	压迫感
熊徒弟	精神力
武道熊师	无形拳
萨戮德	叶子防守
雷吉艾勒奇	电晶体
雷吉铎拉戈	龙颚
雪暴马	苍白嘶鸣
灵幽马	漆黑嘶鸣
蕾冠王	紧张
诡角鹿	威吓
噼斧螳螂	虫之预感
月月熊	毅力
幽尾玄鱼	悠游自如
大狃拉	压迫感
万针鱼	毒刺
眷恋云	迷人之躯
新叶喵	茂盛
蒂蕾喵	茂盛
魔幻假面喵	茂盛
呆火鳄	勐火
炙烫鳄	勐火
骨纹巨声鳄	勐火
润水鸭	激流
涌跃鸭	激流
狂欢浪舞鸭	激流
爱吃豚	芳香
飘香豚	甩不掉的气味
团珠蛛	不眠
操陷蛛	不眠
豆蟋蟀	虫之预感
烈腿蝗	虫之预感
布拨	静电
布土拨	蓄电
巴布土拨	蓄电
一对鼠	逃跑
一家鼠	友情防守
狗仔包	我行我素
麻花犬	焦香
迷你芙	早起
奥利纽	早起
奥利瓦	掉出
怒鹦哥	威吓
盐石宝	洁净
盐石垒	洁净
盐石巨灵	洁净
炭小侍	引火
红莲铠骑	引火
苍炎刃鬼	引火
光蚪仔	我行我素
电肚蛙	电力转换
电海燕	风力发电
大电海燕	风力发电
偶叫獒	威吓
獒教父	威吓
滋汁鼹	轻装
涂标客	轻装
纳噬草	乘风
怖纳噬草	乘风
原野水母	菌丝之力
陆地水母	菌丝之力
毛崖蟹	愤怒甲壳
热辣娃	叶绿素
狠辣椒	叶绿素
虫滚泥	复眼
虫甲圣	同步
飘飘雏	危险预知
超能艳鸵	跟风
小锻匠	破格
巧锻匠	破格
巨锻匠	破格
海地鼠	黏滑
三海地鼠	黏滑
下石鸟	健壮
波普海豚	水幕
海豚侠	全能
噗隆隆	防尘
普隆隆姆	防尘
摩托蜥	蜕皮
拖拖蚓	食土
晶光芽	毒满地因
晶光花	毒满地因
墓仔狗	捡拾
墓扬犬	拨沙
缠红鹤	胆量
走鲸	厚脂肪
浩大鲸	厚脂肪
轻身鳕	破格
吃吼霸	纯朴
米立龙	发号施令
弃世猴	干劲
土王	毒刺
奇麒麟	反刍
土龙节节	天恩
仆斩将军	不服输
雄伟牙	特古代活
吼叫尾	特古代活
勐恶菰	特古代活
振翼发	特古代活
爬地翅	特古代活
沙铁皮	特古代活
铁辙迹	夸克充能
铁包袱	夸克充能
铁臂膀	夸克充能
铁脖颈	夸克充能
铁毒蛾	夸克充能
铁荆棘	夸克充能
凉嵴龙	热交换
冻嵴龙	热交换
戟嵴龙	热交换
索财灵	胆怯
赛富豪	黄金之躯
古简蜗	灾祸之简
古剑豹	灾祸之剑
古鼎鹿	灾祸之鼎
古玉鱼	灾祸
轰鸣月	特古代活
铁武者	夸克充能
故勒顿	绯红脉动
密勒顿	强子引擎
波荡水	特古代活
铁斑叶	夸克充能
